@....@.......@...@................@....@............@.......@.@.
@....@..@@@..@...@....@@@.........@....@..@@@...@@@.@.......@.@.
@@@@@@.@...@.@...@...@...@........@....@.@...@.@....@....@@@@.@.
@....@.@@@@..@...@...@...@........@....@.@...@.@....@...@...@.@.
@....@.@.....@...@...@...@........@.@@.@.@...@.@....@...@...@...
@....@..@@@@..@@..@@..@@@..........@..@...@@@..@.....@@..@@@@.@.
................................................................
 