@....@........@......@....................@....@...............@..........@..@......
@....@..@@@...@......@.......@@@..........@....@..@@@....@@@...@..........@..@......
@@@@@@.@...@..@......@......@...@.........@....@.@...@..@......@.......@@@@..@......
@....@.@@@@...@......@......@...@.........@....@.@...@..@......@......@...@..@......
@....@.@......@......@......@...@.........@.@@.@.@...@..@......@......@...@.........
@....@..@@@@...@@.....@@.....@@@...........@..@...@@@...@.......@@.....@@@@..@......
....................................................................................